000000000000000000000000000000000000
000000000000000000000000000000000000
000000000000000000000000000000000000
000000000000000000000000000000000000
000000000000000000000000000000000000
000000000000000000000000000000000000
111111111111111111111111111111111111
100000000000000001100000000000000001
100000000000000001100000000000000001
100000000000000001100000000000000001
100000111100000000000000001111000001
100000000000000000000000000000000001
100000000000000000000000000000000001
100000000000110000000011000000000001
100001100000100000000001000001100001
100000100000000000000000000001000001
100000100000000000000000000001000001
100000100000000001100000000001000001
100000100000000000000000000001000001
100000100000000000000000000001000001
100001100000100000000001000001100001
100000000000110000000011000000000001
100000000000000000000000000000000001
100000000000000000000000000000000001
100000111100000000000000001111000001
100000000000000001100000000000000001
100000000000000001100000000000000001
100000000000000001100000000000000001
111111111111111111111111111111111111