000000000000000000000000000000000000
000000000000000000000000000000000000
000000000000000000000000000000000000
000000000000000000000000000000000000
000000000000000000000000000000000000
1                                  1
10000000000000000  00000000000000001
10000000000000000  00000000000000001
10000000000000000  00000000000000001
100000   000000000000000000   000001
100000000000000000000000000000000001
100000000000000000000000000000000001
100000000000  00000000  000000000001
100000000000 0000000000 000000000001
10000  0000000000000000000000  00001
100000 0000000000000000000000 000001
100000 0000000000  0000000000 000001
100000 0000000000  0000000000 000001
100000 0000000000000000000000 000001
10000  0000000000000000000000  00001
100000000000 0000000000 000000000001
100000000000  00000000  000000000001
100000000000000000000000000000000001
100000000000000000000000000000000001
100000   000000000000000000   000001
10000000000000000  00000000000000001
10000000000000000  00000000000000001
10000000000000000  00000000000000001
111111111111111111111111111111111111